const short mapa_labirinto3_colisao_map[2500] = {
6, 6, 6, 6, 6, 6, 6, 6, 6, 6, 6, 6, 6, 6, 6, 6, 
6, 6, 6, 6, 6, 6, 6, 6, 6, 6, 6, 6, 6, 6, 6, 6, 
6, 6, 6, 6, 6, 6, 6, 6, 6, 6, 6, 6, 6, 6, 6, 6, 
6, 6,
6, 0, 6, 0, 0, 0, 0, 0, 6, 0, 0, 0, 0, 0, 0, 0, 
0, 0, 0, 0, 0, 0, 0, 0, 6, 0, 6, 0, 0, 0, 0, 0, 
6, 0, 0, 0, 0, 0, 0, 6, 0, 0, 0, 6, 0, 0, 0, 0, 
0, 6,
6, 0, 6, 0, 0, 0, 0, 0, 6, 0, 0, 0, 0, 0, 0, 0, 
0, 0, 0, 0, 0, 0, 0, 0, 6, 0, 6, 0, 0, 0, 0, 0, 
6, 0, 0, 0, 0, 0, 0, 6, 0, 0, 0, 6, 0, 0, 0, 0, 
0, 6,
6, 0, 6, 6, 6, 6, 6, 0, 6, 0, 6, 6, 6, 6, 6, 6, 
6, 6, 6, 6, 6, 6, 6, 0, 6, 0, 0, 6, 6, 6, 6, 0, 
6, 0, 0, 0, 0, 6, 0, 0, 0, 6, 0, 0, 0, 6, 0, 0, 
0, 6,
6, 0, 0, 0, 0, 0, 0, 0, 6, 0, 0, 0, 0, 6, 0, 0, 
0, 6, 0, 0, 0, 0, 6, 0, 0, 0, 0, 0, 0, 0, 6, 0, 
6, 0, 0, 0, 0, 6, 0, 0, 0, 6, 0, 0, 0, 6, 0, 0, 
0, 6,
6, 0, 0, 0, 0, 0, 0, 0, 6, 0, 0, 0, 0, 6, 0, 0, 
0, 6, 0, 0, 0, 0, 6, 0, 0, 0, 0, 0, 0, 0, 6, 0, 
6, 6, 6, 6, 0, 6, 6, 6, 6, 6, 6, 6, 6, 6, 6, 6, 
0, 6,
6, 6, 6, 6, 6, 6, 0, 0, 6, 6, 6, 6, 6, 6, 0, 6, 
0, 6, 0, 6, 0, 0, 6, 6, 6, 6, 6, 6, 6, 0, 6, 0, 
0, 0, 0, 6, 0, 0, 0, 6, 0, 0, 0, 0, 0, 0, 0, 6, 
0, 6,
6, 0, 0, 0, 0, 0, 0, 0, 0, 0, 0, 0, 0, 0, 0, 6, 
0, 6, 0, 6, 0, 0, 0, 0, 0, 0, 0, 0, 6, 0, 6, 0, 
0, 0, 0, 6, 0, 0, 0, 6, 0, 0, 0, 0, 0, 0, 0, 6, 
0, 6,
6, 0, 0, 0, 0, 0, 0, 0, 0, 0, 0, 0, 0, 0, 0, 6, 
0, 6, 0, 6, 0, 0, 0, 0, 0, 0, 0, 0, 6, 0, 6, 6, 
6, 0, 0, 6, 6, 6, 6, 6, 0, 0, 6, 6, 6, 6, 6, 6, 
0, 6,
6, 6, 6, 6, 6, 6, 6, 6, 6, 6, 6, 6, 0, 0, 6, 6, 
0, 6, 0, 6, 0, 6, 6, 6, 6, 6, 0, 0, 6, 0, 0, 0, 
0, 0, 0, 0, 0, 0, 0, 0, 0, 0, 0, 0, 0, 0, 0, 0, 
0, 6,
6, 0, 0, 0, 0, 0, 0, 0, 0, 0, 0, 6, 0, 0, 0, 6, 
0, 6, 0, 6, 0, 6, 0, 0, 0, 0, 0, 0, 6, 0, 0, 0, 
0, 0, 0, 0, 0, 0, 0, 0, 0, 0, 0, 0, 0, 0, 0, 0, 
0, 6,
6, 0, 0, 0, 0, 0, 0, 0, 0, 0, 0, 6, 0, 0, 0, 6, 
0, 6, 0, 6, 0, 6, 0, 0, 0, 0, 0, 0, 6, 6, 6, 6, 
6, 6, 6, 6, 6, 0, 6, 6, 6, 6, 6, 6, 6, 6, 6, 6, 
0, 6,
6, 0, 6, 6, 6, 6, 6, 6, 6, 6, 0, 6, 0, 6, 6, 6, 
0, 6, 0, 6, 0, 6, 6, 6, 6, 6, 6, 6, 6, 0, 0, 0, 
0, 0, 0, 0, 0, 0, 6, 0, 0, 0, 0, 0, 0, 0, 0, 6, 
0, 6,
6, 0, 6, 0, 0, 0, 0, 0, 0, 6, 0, 6, 0, 6, 0, 0, 
0, 6, 0, 6, 0, 6, 0, 0, 0, 0, 0, 0, 0, 0, 0, 0, 
0, 0, 0, 0, 0, 0, 6, 0, 0, 0, 0, 0, 0, 0, 0, 6, 
0, 6,
6, 0, 6, 0, 0, 0, 0, 0, 0, 6, 0, 6, 0, 6, 0, 0, 
0, 6, 0, 6, 0, 6, 0, 0, 0, 0, 0, 0, 0, 0, 0, 0, 
0, 0, 0, 6, 0, 0, 6, 6, 6, 6, 0, 6, 6, 6, 6, 6, 
0, 6,
6, 6, 6, 0, 0, 6, 6, 6, 6, 6, 0, 6, 6, 6, 0, 6, 
6, 6, 0, 6, 0, 6, 6, 6, 6, 6, 6, 6, 6, 6, 6, 6, 
6, 6, 0, 6, 6, 6, 6, 6, 0, 6, 0, 6, 0, 0, 0, 0, 
0, 6,
6, 0, 0, 0, 0, 0, 0, 0, 0, 0, 0, 0, 0, 0, 0, 0, 
0, 0, 0, 6, 0, 0, 0, 0, 0, 0, 0, 0, 0, 0, 0, 0, 
0, 0, 0, 0, 0, 0, 0, 0, 0, 6, 0, 6, 0, 0, 0, 0, 
0, 6,
6, 0, 0, 0, 0, 0, 0, 0, 0, 0, 0, 0, 0, 0, 0, 0, 
0, 0, 0, 6, 0, 0, 0, 0, 0, 0, 0, 0, 0, 0, 0, 0, 
0, 0, 0, 0, 0, 0, 0, 0, 0, 6, 0, 6, 6, 6, 6, 6, 
6, 6,
6, 0, 6, 6, 6, 6, 6, 6, 0, 6, 6, 6, 6, 6, 0, 6, 
6, 6, 6, 6, 6, 6, 6, 6, 6, 6, 6, 6, 6, 6, 6, 6, 
6, 6, 0, 6, 6, 6, 6, 0, 0, 6, 0, 0, 0, 0, 0, 0, 
0, 6,
6, 0, 6, 0, 0, 0, 0, 6, 0, 6, 0, 0, 0, 6, 0, 6, 
0, 6, 0, 0, 0, 0, 6, 0, 0, 0, 0, 0, 0, 0, 0, 0, 
0, 0, 0, 6, 0, 6, 0, 0, 0, 6, 0, 0, 0, 0, 0, 0, 
0, 6,
6, 0, 6, 0, 0, 0, 0, 6, 0, 6, 0, 0, 0, 6, 0, 6, 
0, 6, 0, 0, 0, 0, 6, 0, 0, 0, 0, 0, 0, 0, 0, 0, 
0, 0, 0, 6, 0, 6, 0, 0, 0, 6, 0, 0, 6, 6, 6, 6, 
0, 6,
6, 6, 6, 0, 0, 6, 0, 6, 0, 6, 6, 6, 0, 6, 6, 6, 
0, 6, 6, 6, 6, 0, 6, 0, 6, 6, 6, 6, 6, 6, 0, 6, 
6, 6, 6, 6, 0, 6, 0, 6, 6, 6, 0, 0, 0, 0, 0, 6, 
0, 6,
6, 0, 0, 0, 0, 6, 0, 6, 0, 0, 0, 6, 0, 0, 0, 0, 
0, 0, 0, 0, 6, 0, 6, 0, 0, 0, 0, 0, 0, 0, 0, 6, 
0, 0, 0, 0, 0, 6, 0, 6, 0, 0, 0, 0, 0, 0, 0, 6, 
0, 6,
6, 0, 0, 0, 0, 6, 0, 6, 0, 0, 0, 6, 0, 0, 0, 0, 
0, 0, 0, 0, 6, 0, 6, 0, 0, 0, 0, 0, 0, 0, 0, 6, 
0, 0, 0, 0, 0, 6, 0, 6, 0, 0, 0, 6, 6, 6, 6, 6, 
0, 6,
6, 0, 6, 6, 6, 6, 0, 6, 0, 6, 0, 6, 0, 6, 6, 6, 
6, 6, 0, 0, 6, 0, 6, 6, 0, 6, 6, 6, 0, 0, 0, 6, 
0, 6, 6, 6, 0, 6, 6, 6, 0, 0, 6, 6, 0, 0, 0, 0, 
0, 6,
6, 0, 6, 0, 0, 0, 0, 6, 0, 6, 0, 6, 0, 6, 0, 0, 
0, 0, 0, 0, 6, 0, 0, 6, 0, 6, 0, 0, 0, 6, 0, 6, 
0, 6, 0, 6, 0, 0, 0, 0, 0, 0, 0, 6, 0, 0, 0, 0, 
0, 6,
6, 0, 6, 0, 0, 0, 0, 6, 0, 6, 0, 6, 0, 6, 0, 0, 
0, 0, 0, 0, 6, 0, 0, 6, 0, 6, 0, 0, 0, 6, 0, 6, 
0, 6, 0, 6, 0, 0, 0, 0, 0, 0, 0, 6, 0, 6, 6, 6, 
6, 6,
6, 0, 6, 6, 6, 6, 6, 6, 0, 6, 6, 6, 0, 6, 0, 6, 
6, 6, 6, 6, 6, 0, 0, 6, 0, 6, 6, 6, 6, 6, 0, 6, 
0, 6, 0, 6, 6, 6, 6, 6, 0, 0, 0, 6, 0, 6, 0, 0, 
0, 6,
6, 0, 0, 0, 0, 0, 0, 0, 0, 6, 0, 0, 0, 6, 0, 6, 
0, 0, 0, 0, 0, 0, 0, 6, 0, 0, 0, 0, 0, 0, 0, 6, 
0, 6, 0, 0, 0, 0, 0, 6, 0, 6, 0, 6, 0, 6, 0, 0, 
0, 6,
6, 0, 0, 0, 0, 0, 0, 0, 0, 6, 0, 6, 6, 6, 0, 6, 
0, 0, 0, 0, 0, 0, 0, 6, 0, 0, 0, 0, 0, 0, 0, 6, 
0, 6, 0, 0, 0, 0, 0, 6, 0, 6, 0, 6, 0, 6, 0, 6, 
0, 6,
6, 0, 6, 6, 6, 6, 6, 6, 0, 6, 0, 6, 0, 6, 0, 6, 
6, 6, 6, 6, 6, 6, 0, 6, 6, 6, 6, 6, 6, 6, 6, 6, 
0, 6, 6, 6, 0, 0, 0, 6, 0, 6, 0, 6, 0, 6, 0, 6, 
0, 6,
6, 0, 6, 0, 0, 0, 0, 6, 0, 6, 0, 6, 0, 6, 0, 0, 
0, 0, 0, 0, 0, 6, 0, 0, 0, 0, 0, 0, 0, 0, 0, 6, 
0, 0, 0, 6, 0, 6, 0, 6, 0, 6, 0, 6, 0, 6, 0, 6, 
0, 6,
6, 0, 6, 0, 0, 0, 0, 6, 0, 6, 0, 6, 0, 6, 0, 0, 
0, 0, 0, 0, 0, 6, 0, 0, 0, 0, 0, 0, 0, 0, 0, 6, 
0, 0, 0, 6, 0, 6, 0, 6, 0, 6, 0, 6, 0, 6, 0, 6, 
0, 6,
6, 0, 6, 0, 0, 6, 6, 6, 0, 6, 0, 6, 0, 6, 6, 6, 
6, 6, 6, 6, 0, 6, 6, 6, 6, 6, 6, 6, 6, 6, 6, 6, 
6, 6, 6, 6, 0, 0, 6, 6, 0, 6, 0, 6, 6, 6, 0, 6, 
0, 6,
6, 0, 6, 0, 0, 0, 0, 0, 0, 6, 6, 6, 0, 0, 0, 0, 
0, 0, 0, 0, 0, 6, 0, 0, 0, 0, 0, 0, 0, 0, 0, 0, 
0, 0, 0, 0, 0, 0, 0, 0, 0, 6, 0, 0, 0, 0, 0, 6, 
0, 6,
6, 0, 6, 0, 0, 0, 0, 0, 0, 0, 0, 0, 0, 0, 0, 0, 
0, 0, 0, 0, 0, 6, 0, 0, 0, 0, 0, 0, 0, 0, 0, 0, 
0, 0, 0, 0, 0, 0, 0, 0, 0, 6, 0, 0, 0, 0, 0, 6, 
0, 6,
6, 0, 6, 0, 6, 6, 6, 0, 0, 0, 0, 0, 0, 0, 6, 6, 
6, 6, 6, 6, 6, 6, 6, 6, 6, 6, 6, 6, 6, 6, 6, 6, 
6, 6, 6, 6, 6, 0, 0, 6, 6, 6, 6, 6, 6, 6, 6, 6, 
0, 6,
6, 0, 6, 0, 6, 0, 6, 6, 6, 6, 6, 6, 6, 0, 0, 0, 
0, 0, 0, 0, 0, 0, 0, 0, 0, 0, 0, 0, 0, 0, 0, 0, 
0, 0, 0, 0, 6, 0, 0, 0, 0, 6, 0, 6, 0, 0, 0, 6, 
0, 6,
6, 0, 6, 0, 6, 0, 0, 0, 0, 0, 0, 0, 0, 0, 0, 0, 
0, 0, 0, 0, 0, 0, 0, 0, 0, 0, 0, 0, 0, 0, 0, 0, 
0, 0, 0, 0, 6, 0, 0, 0, 0, 6, 0, 6, 0, 0, 0, 6, 
0, 6,
6, 0, 6, 0, 6, 0, 0, 0, 0, 0, 0, 0, 0, 0, 0, 6, 
6, 6, 6, 6, 0, 0, 6, 6, 6, 6, 6, 6, 0, 6, 0, 0, 
0, 0, 0, 0, 6, 0, 6, 6, 0, 6, 0, 0, 6, 6, 0, 6, 
0, 6,
6, 0, 6, 0, 6, 6, 6, 0, 6, 6, 6, 6, 6, 6, 0, 6, 
0, 0, 0, 0, 0, 0, 0, 0, 0, 6, 0, 6, 0, 6, 0, 6, 
6, 6, 6, 0, 6, 0, 6, 0, 0, 0, 0, 0, 0, 0, 0, 6, 
0, 6,
6, 0, 6, 0, 0, 0, 6, 0, 6, 0, 0, 0, 0, 0, 0, 6, 
0, 0, 0, 0, 0, 0, 0, 0, 0, 6, 0, 6, 0, 6, 0, 0, 
0, 0, 6, 0, 6, 0, 6, 0, 0, 0, 0, 0, 0, 0, 0, 6, 
0, 6,
6, 0, 6, 0, 0, 0, 6, 0, 6, 0, 0, 0, 0, 0, 0, 6, 
0, 6, 6, 6, 6, 6, 6, 6, 0, 6, 0, 6, 0, 6, 0, 0, 
0, 0, 6, 0, 6, 0, 6, 6, 0, 6, 6, 6, 0, 0, 0, 6, 
0, 6,
6, 0, 6, 6, 6, 0, 6, 0, 6, 6, 6, 6, 0, 6, 6, 6, 
0, 6, 0, 0, 0, 0, 0, 0, 0, 6, 0, 6, 0, 6, 6, 6, 
6, 0, 6, 0, 6, 0, 0, 6, 0, 6, 0, 6, 6, 6, 6, 6, 
0, 6,
6, 0, 0, 0, 6, 0, 6, 0, 0, 0, 0, 6, 0, 6, 0, 0, 
0, 6, 0, 0, 0, 0, 0, 0, 0, 6, 0, 6, 0, 0, 0, 0, 
6, 0, 6, 0, 0, 0, 0, 6, 0, 6, 0, 0, 0, 0, 0, 0, 
0, 6,
6, 0, 0, 0, 6, 0, 6, 0, 0, 0, 0, 6, 0, 6, 0, 0, 
0, 6, 0, 6, 6, 6, 6, 6, 0, 6, 0, 6, 0, 0, 0, 0, 
6, 0, 6, 0, 0, 0, 0, 6, 0, 6, 0, 0, 0, 0, 0, 0, 
0, 6,
6, 6, 6, 6, 6, 0, 6, 0, 6, 6, 6, 6, 0, 6, 0, 6, 
6, 6, 0, 6, 0, 0, 0, 6, 0, 6, 0, 6, 0, 6, 6, 6, 
6, 0, 6, 6, 6, 6, 6, 6, 6, 6, 6, 6, 6, 0, 0, 0, 
0, 6,
6, 0, 0, 0, 0, 0, 6, 0, 6, 0, 0, 0, 0, 6, 0, 0, 
0, 0, 0, 0, 0, 0, 0, 6, 0, 6, 0, 0, 0, 6, 0, 0, 
0, 0, 0, 0, 0, 6, 0, 0, 0, 0, 0, 0, 0, 0, 0, 0, 
0, 6,
6, 0, 0, 0, 0, 0, 6, 0, 6, 0, 0, 0, 0, 6, 0, 0, 
0, 0, 0, 0, 0, 0, 0, 6, 0, 6, 0, 0, 0, 6, 0, 0, 
0, 0, 0, 0, 0, 6, 0, 0, 0, 0, 0, 0, 0, 0, 0, 0, 
0, 6,
6, 6, 6, 6, 6, 6, 6, 6, 6, 6, 6, 6, 6, 6, 6, 6, 
6, 6, 6, 6, 6, 6, 6, 6, 6, 6, 6, 6, 6, 6, 6, 6, 
6, 6, 6, 6, 6, 6, 6, 6, 6, 6, 6, 6, 6, 6, 6, 6, 
6, 6
};

